1111111111111111
1P0000000C0000E1
1011110111111101
1000000100000001
1111101110111111
1C00000000000CE1
1111111111111111